NO textures/wall_north2.xpm

SO textures/wall_north2.xpm

WE textures/wall_north2.xpm

EA textures/wall_north2.xpm

DO textures/door2.xpm

DC textures/door.xpm


C 30,30,101

F 100,100,101



1111111111111111111111111111111111111111111111111111111111111
1S0000001000000010001000000100000001000100000001000000100001
1011101010111010101110101011101010111010101110101011101010111
1000001010001000001000101000001010001010001000101000001010001
1011111011101111101110101111101011101011101010111110101110111
1000100000001000000010001000001000001010001010000010001000001
1110101111101011111010101011111011110101110101111110101011111
1000101000001000000010101000000000010101000101000000101000001
1011101011111011111110101111111111110101011101011111101111101
1010001000000000000000101000000000000101000001000000001000101
1010111111111111111110101011111111110101111110111111110101101
1010000000000000000010101010000000010101000000100000000101001
1011111111111111111110101010111111010101011111101111111101011
1000000000000000000000101010100000010101010000001000000001011
1111111111111111111110101010101111110101010111110101111111011
1000000000000000000010001010101000000101010100000101000000001
1011111111111111111110111110101011111101010101111101011111111
1010000000000000000000000000101010000001010101000001010000001
1010111111111111111111111110101010111110101010111110101011111
1010100000000000000000000010001010100000101010100000101010001
1010101111111111111111111010111110101111101010101111101010101
1010101000000000000000001010000000101000001010101000001010101
1010101011111111111111101011111110101111110101010111110101101
1010101010000000000000101000000010101000000101010100000101001
1010101010111111111110101111111010101011111101010101111101011
1010101010100000000010101000000010101010000001010101000001011
1010101010101111111110101011111110101010111110101010111111011
1010101010101000000000101010000000101010100000101010100000001
1010101010101011111110101010111111101010101111101010101111111
1010101010101010000010101010100000001010101000001010101000001
1010101010101010111110101010101111110101010111110101010101111
1000101010101010100000101010101000000101010100000101010101001
1111101010101010101111101010101011111101010101111101010101011
1000001010101010101000001010101010000001010101000001010101011
1011111010101010101011111010101010111110101010111110101010111
1010000010101010101010000010101010100000101010100000101010101
1010111110101010101010111110101010101111101010101111101010101
1010100000101010101010100000101010101000001010101000001010101
1010101111101010101010101111101010101011110101010111110101011
1010101000001010101010101000001010101010000010101010000010101
1010101011111010101010101011111010101010111110101010111110101
1010101010000010101010101010000010101010100000101010100000101
1010101010111110101010101010111110101010101111101010101111101
1010101010100000101010101010100000101010101000001010101000001
1010101010101111101010101010101111101010101011110101010111111
1000101010101000001010101010101000001010101010000010101010001
1111101010101011111010101010101011111010101010111110101010111
1000001010101010000010101010101010000010101010100000101010101
1011111010101010111110101010101010111110101010101111101010101
1010000010101010100000101010101010100000101010101000001010101
1010111110101010101111101010101010101111101010101011110101011
1010100000101010101000001010101010101000001010101010000010101
1010101111101010101011111010101010101011111010101010111110101
1010101000001010101010000010101010101010000010101010100000001
1010101011111010101010111110101010101010111110101010101111111
1010101010000010101010100000101010101010100000101010101000001
1010101010111110101010101111101010101010101111101010101011111
1010101010100000101010101000001010101010101000001010101010001
1010101010101111101010101011111010101010101011111010101010101
1010101010101000001010101010000010101010101010000010101010101
1010101010101011111010101010111110101010101010111110101010101
1000101010101010000010101010100000101010101010100000101010101
1111101010101010111110101010101111101010101010101111101010101
1000001010101010100000101010101000001010101010101000001010101
1011111010101010101111101010101011111010101010101011111010101
1010000010101010101000001010101010000010101010101010000010101
1010111110101010101011111010101010111110101010101010111110101
1010100000101010101010000010101010100000101010101010100000101
1010101111101010101010111110101010101111101010101010101111101
1010101000001010101010100000101010101000001010101010101000001
1010101011111010101010101111101010101011111010101010101011111
1010101010000010101010101000001010101010000010101010101010001
1010101010111110101010101011111010101010111110101010101010111
1010101010100000101010101010000010101010100000101010101010101
1010101010101111101010101010111110101010101111101010101010101
1010101010101000001010101010100000101010101000001010101010101
1010101010101011111010101010101111101010101011111010101010101
1000101010101010000010101010101000001010101010000010101010101
1111101010101010111110101010101011111010101010111110101010101
1000001010101010100000101010101010000010101010100000101010101
1011111010101010101111101010101010111110101010101111101010101
1010000010101010101000001010101010100000101010101000001010101
1010111110101010101011111010101010101111101010101011111010101
1010100000101010101010000010101010101000001010101010000010101
1010101111101010101010111110101010101011111010101010111110101
1010101000001010101010100000101010101010000010101010100000101
1010101011111010101010101111101010101010111110101010101111101
1010101010000010101010101000001010101010100000101010101000001
1010101010111110101010101011111010101010101111101010101011111
1010101010100000101010101010000010101010101000001010101010001
1010101010101111101010101010111110101010101011111010101010111
1010101010101000001010101010100000101010101010000010101010101
1010101010101011111010101010101111101010101010111110101010101
1000101010101010000010101010101000001010101010100000101010101
1111101010101010111110101010101011111010101010101111101010101
1000001010101010100000101010101010000010101010101000001010101
1011111010101010101111101010101010111110101010101011111010101
1010000010101010101000001010101010100000101010101010000010101
1010111110101010101011111010101010101111101010101010111110101
1010100000101010101010000010101010101000001010101010100000101
1010101111101010101010111110101010101011111010101010101111101
1010101000001010101010100000101010101010000010101010101000001
1010101011111010101010101111101010101010111110101010101011111
1010101010000010101010101000001010101010100000101010101010001
1010101010111110101010101011111010101010101111101010101010111
1010101010100000101010101010000010101010101000001010101010101
1010101010101111101010101010111110101010101011111010101010101
1010101010101000001010101010100000101010101010000010101010101
1010101010101011111010101010101111101010101010111110101010101
1000101010101010000010101010101000001010101010100000101010101
1111101010101010111110101010101011111010101010101111101010101
1000001010101010100000101010101010000010101010101000001010101
1011111010101010101111101010101010111110101010101011111010101
1010000010101010101000001010101010100000101010101010000010101
1010111110101010101011111010101010101111101010101010111110101
1010100000101010101010000010101010101000001010101010100000101
1010101111101010101010111110101010101011111010101010101111101
1010101000001010101010100000101010101010000010101010101000001
1010101011111010101010101111101010101010111110101010101011111
1010101010000010101010101000001010101010100000101010101010001
1010101010111110101010101011111010101010101111101010101010111
1010101010100000101010101010000010101010101000001010101010101
1010101010101111101010101010111110101010101011111010101010101
1010101010101000001010101010100000101010101010000010101010101
1010101010101011111010101010101111101010101010111110101010101
1000101010101010000010101010101000001010101010100000101010101
1111101010101010111110101010101011111010101010101111101010101
1000001010101010100000101010101010000010101010101000001010101
1011111010101010101111101010101010111110101010101011111010101
1010000010101010101000001010101010100000101010101010000010101
1010111110101010101011111010101010101111101010101010111110101
1010100000101010101010000010101010101000001010101010100000101
1010101111101010101010111110101010101011111010101010101111101
1000101000001010101010100000101010101010000010101010101000001
1111101011111010101010101111101010101010111110101010101011111
1000001010000010101010101000001010101010100000101010101010001
1011111010111110101010101011111010101010101111101010101010111
1010000010100000101010101010000010101010101000001010101010101
1010111110101111101010101010111110101010101011111010101010101
1010100000101000001010101010100000101010101010000010101010101
1010101111101011111010101010101111101010101010111110101010101
1010101000001010000010101010101000001010101010100000101010101
1010101011111010111110101010101011111010101010101111101010101
1010101010000010100000101010101010000010101010101000001010101
1010101010111110101111101010101010111110101010101011111010101
1010101010100000101000001010101010100000101010101010000010101
1010101010101111101011111010101010101111101010101010111110101
1010101010101000001010000010101010101000001010101010100000101
1010101010101011111010111110101010101011111010101010101111101
1010101010101010000010100000101010101010000010101010101000001
1010101010101010111110101111101010101010111110101010101011111
1000101010101010100000101000001010101010100000101010101010001
1111101010101010101111101011111010101010101111101010101010111
1000001010101010101000001010000010101010101000001010101010101
1011111010101010101011111010111110101010101011111010101010101
1010000010101010101010000010100000101010101010000010101010101
1010111110101010101010111110101111101010101010111110101010101
1010100000101010101010100000101000001010101010100000101010101
1010101111101010101010101111101011111010101010101111101010101
1010101000001010101010101000001010000010101010101000001010101
1010101011111010101010101011111010111110101010101011111010101
1010101010000010101010101010000010100000101010101010000010101
1010101010111110101010101010111110101111101010101010111110101
1000101010100000101010101010100000101000001010101010100000101
1111101010101111101010101010101111101011111010101010101111101
1000001010101000001010101010101000001010000010101010101000001
1011111010101011111010101010101011111010111110101010101011111
1010000010101010000010101010101010000010100000101010101010001
1010111110101010111110101010101010111110101111101010101010111
1010100000101010100000101010101010100000101000001010101010101
1010101111101010101111101010101010101111101011111010101010101
1010101000001010101000001010101010101000001010000010101010101
1010101011111010101011111010101010101011111010111110101010101
1010101010000010101010000010101010101010000010100000101010101
1010101010111110101010111110101010101010111110101111101010101
1010101010100000101010100000101010101010100000101000001010101
1010101010101111101010101111101010101010101111101011111010101
1010101010101000001010101000001010101010101000001010000010101
1010101010101011111010101011111010101010101011111010111110101
1000101010101010000010101010000010101010101010000010100000101
1111101010101010111110101010111110101010101010111110101111101
1000001010101010100000101010100000101010101010100000101000001
1011111010101010101111101010101111101010101010101111101011111
1010000010101010101000001010101000001010101010101000001010001
1010111110101010101011111010101011111010101010101011111010111
1010100000101010101010000010101010000010101010101010000010101
1010101111101010101010111110101010111110101010101010111110101
1010101000001010101010100000101010100000101010101010100000101
1010101011111010101010101111101010101111101010101010101111101
1010101010000010101010101000001010101000001010101010101000001
1010101010111110101010101011111010101011111010101010101011111
1010101010100000101010101010000010101010000010101010101010001
1010101010101111101010101010111110101010111110101010101010111
1010101010101000001010101010100000101010100000101010101010101
1010101010101011111010101010101111101010101111101010101010101
1000101010101010000010101010101000001010101000001010101010101
1111101010101010111110101010101011111010101011111010101010101
1000001010101010100000101010101010000010101010000010101010101
1011111010101010101111101010101010111110101010111110101010101
1010000010101010101000001010101010100000101010100000101010101
1010111110101010101011111010101010101111101010101111101010101
1010100000101010101010000010101010101000001010101000001010101
1010101111101010101010111110101010101011111010101011111010101
1000101000001010101010100000101010101010000010101010000010101
1111101011111010101010101111101010101010111110101010111110101
1000001010000010101010101000001010101010100000101010100000101
1011111010111110101010101011111010101010101111101010101111101
1010000010100000101010101010000010101010101000001010101000001
1010111110101111101010101010111110101010101011111010101011111
1010100000101000001010101010100000101010101010000010101010001
1010101111101011111010101010101111101010101010111110101010111
1010101000001010000010101010101000001010101010100000101010101
1010101011111010111110101010101011111010101010101111101010101
1010101010000010100000101010101010000010101010101000001010101
1010101010111110101111101010101010111110101010101011111010101
1010101010100000101000001010101010100000101010101010000010101
1010101010101111101011111010101010101111101010101010111110101
1010101010101000001010000010101010101000001010101010100000101
1010101010101011111010111110101010101011111010101010101111101
1010101010101010000010100000101010101010000010101010101000001
1010101010101010111110101111101010101010111110101010101011111
1000101010101010100000101000001010101010100000101010101010001
1111101010101010101111101011111010101010101111101010101010111
1000001010101010101000001010000010101010101000001010101010101
1011111010101010101011111010111110101010101011111010101010101
1010000010101010101010000010100000101010101010000010101010101
1010111110101010101010111110101111101010101010111110101010101
1010100000101010101010100000101000001010101010100000101010101
1010101111101010101010101111101011111010101010101111101010101
1010101000001010101010101000001010000010101010101000001010101
1010101011111010101010101011111010111110101010101011111010101
1010101010000010101010101010000010100000101010101010000010101
1010101010111110101010101010111110101111101010101010111110101
1010101010100000101010101010100000101000001010101010100000101
1010101010101111101010101010101111101011111010101010101111101
1010101010101000001010101010101000001010000010101010101000001
1010101010101011111010101010101011111010111110101010101011111
1010101010101010000010101010101010000010100000101010101010001
1010101010101010111110101010101010111110101111101010101010111
1000101010101010100000101010101010100000101000001010101010101
1111101010101010101111101010101010101111101011111010101010101
1000001010101010101000001010101010101000001010000010101010101
1011111010101010101011111010101010101011111010111110101010101
1010000010101010101010000010101010101010000010100000101010101
1010111110101010101010111110101010101010111110101111101010101
1010100000101010101010100000101010101010100000101000001010101
1010101111101010101010101111101010101010101111101011111010101
1010101000001010101010101000001010101010101000001010000010101
1010101011111010101010101011111010101010101011111010111110101
1010101010000010101010101010000010101010101010000010100000101
1010101010111110101010101010111110101010101010111110101111101
1010101010100000101010101010100000101010101010100000101000001
1010101010101111101010101010101111101010101010101111101011111
1000101010101000001010101010101000001010101010101000001010001
11111010101010111110101010101010111110101010101010111110101111
100000101010101000001010101010101000001010101010101000001010D01
11111111111111111111111111111111111111111111111111111111111111
