NO textures/miracle.gif/

SO textures/crisanta.gif/

WE textures/jabrail.gif/

EA textures/panatent_one.gif/

DO textures/open_gate.gif/

DC textures/space.gif/


C 30,30,101

F 100,100,101


11111111111111111111111111111111111111111
1S0000D0100000000010001100001100100000001
10111110101011111010101011101111111011101
10000010001000111000101000100111000010101
11111011111110101111101111111111111111111
11001000001000100000101000000010101101101
11101111101011101110101011111011101011101
11111000101011111010101010001000101010101
10111110101010111010101010111110101111101
11011110101010001001100011000110111011001
11101010101011111011111111111110101010111
11001010100010101010000000101110100010011
10111111111111111111111010111010111011101
10100001000110000010100011000010001010001
11111110111111111011111111111111101010101
10110010001001010110100010000010001111101
10111111101111111010111110111010111011111
10001011101011101110001010001000100010001
111110101110111011111010111011111111111011111111111
1000001010110010101000101000000000000000D0000000001
111111111111111111111111111111111111111111111111111
