NO textures/wall_north.xpm

SO textures/wall_south.xpm

WE textures/wall_west.xpm

EA textures/wall_east.xpm

DO textures/door2.xpm

DC textures/door.xpm


C 70,70,255

F 225,225,225


11111111111111111111111111111111111111111
1S0000000000000D0000000000000000000000001
10000100001000010000100001000010000100001
10000100001000010000100001000010000100001
100000000000000D0000000000000000000000001
10000100001000010000100001000010000100001
10000100001000010000100001000010000100001
10000100001000010000100001000010000100001
100000000000000D0000000000000000000000001
10000100001000010000100001000010000100001
10000100001000010000100001000010000100001
10000100001000010000100001000010000100001
10000000000000000000000000000000000000001
10000100001000010000100001000010000100001
10000100001000010000100001000010000100001
10000100001000010000100001000010000100001
10000000000000000000000000000000000000001
10000100001000010000100001000010000100001
10000100001000010000100001000010000100001
10000100001000010000100001000010000100001
10000000000000000000000000000000000000001
10000100001000010000100001000010000100001
100001000010000100001000010000100001000111111
100000000000000000000000000000000000000D00001
111111111111111111111111111111111111111111111
