NO textures/wall_north.xpm

SO textures/wall_south.xpm

WE textures/wall_west.xpm

EA textures/wall_east.xpm

DO textures/door2.xpm

DC textures/door.xpm


C 70,70,255

F 225,225,225



111111111111111111111111111111111
100000000000000000000000000000001
110000110000000111000000000000111
100000000001000000000000000000001
1111111110110S000D0110000000000001
100000000011000000110111111111111
11110111111111011000000010001
11110111111111011101010010001
11000000110101011100100010001
10000000000000001100000010001
10000000000000001101010000001
1100000111010101111101111000111
11110111 1110101 101111010001
11111111 1111111 111111111111
