NO textures/wall_north2.xpm

SO textures/wall_north2.xpm

WE textures/wall_north2.xpm

EA textures/wall_north2.xpm

DO textures/door2.xpm

DC textures/door.xpm


C 30,30,101

F 100,100,101



11111111111111111111111111111111111111111111111111111111111111
1E000000000000000000000000000000000000000000000000000000000001
11111111111111011111111110111111111111111111111111011111111111
11111111111111D11111111110111111111111111111111111011111110011
11111111111111011111111110111111111111111111111111000D00011011
11111111111111011111111110111111111111111111111111111111011011
11111111111110000000000010111111111111111111111111111111000011
11111111111111111111111111111111111111111111111111111111111111
