NO textures/miracle.gif/

SO textures/crisanta.gif/

WE textures/jabrail.gif/

EA textures/panatent_one.gif/

DO textures/open_gate.gif/

DC textures/space.gif/


C 30,30,101

F 100,100,101



11111111111111111111111111111111111111111111111111111111111111
1E000000000000000000000000000000000000000000000000000000000001
11111111111111011111111010111111111111111111111111011111110111
11101111111111D11111111010111100000000001011111111011111110011
11101000000000000000000010111101111111111011111111000D00011011
11101011111111011111111110111101111111111011111111111111011011
11101011111110000000000010111101111111111011111111101111000011
11101011111110111101111011111101111111111011111111101111101111
11101011111110111101111011111101111111111011111111101111101111
11101011111110111101111011111101111111111011111111101111101111
11101011111110111101111011000000000000000000000000000000001111
111010111111101111011110111101111111111111111111111111111D1111
11101011111110111101111011110111111111111111111111111111101111
11101011111110111101111011110000D00000000000000000000001101111
11101011111110111101111011111111111111111111111111111111101111
11101011111110111101111000000000000000000000000000111111101111
111D1011111110111101111011111111111111111111111110111111101111
11101011111110111101111001111111111111111111111110111111101111
11101011111110111101111010000000000000000011111110111111101111
11101011111110111101111011111111111111101011111110111111101111
11101011111110111101111011111111111111101011111110111111101111
11101011111110111101111011111111111111101011111110111111101111
11101000000000111101111011111111111111101011111110111111101111
11101111111110111101111011111111111100001011111110111111101111
11101111111110111101111011111111111101111011111110111111101111
11101111111110111101111011111111111101111011111110111111101111
11101111111110111101111011111111111101111011111110000000101111
11101111111110111101111011111110001001111011111111111110101111
11101111111110111101111011111110111011111000000011111110101111
11101111111110111101111000000000111011111111111011111110101111
11101111111110111101111011101111111011111111111011111110101111
11101111111110111101111011101111111011111111111011111110101111
11101111111110111101111011101111111011111111111000001110101111
11101111111110111101111011101111111011111111111111101110101111
11101111111110111101111011100000000011111111111111101110101111
111011111111111111111111111111111111111111111111111011111111111111111111111111111111111111111111111111111
1000000000000D00000000000000000000000000000000000000000000000000000000000000000D0000000000000000000000001
111111111111111111111111111111111111111111111111111111111111111111111111111111111111111111111111111111111
